16 17 17 17 17 17 17 17 17 17 17 17 17 17 17 17 17 17 17 17 17 17 17 17 17 17 17 17 17 17 17 17 17 17 17 17 17 17 17 17 17 17 17 17 17 17 17 17 17 17 17 17 17 17 17 17 17 17 17 18 
19 20 20 20 20 20 20 20 20 20 20 20 20 20 20 20 20 20 20 20 20 20 20 20 20 20 20 20 20 20 20 20 20 20 20 20 20 20 20 20 20 20 20 20 20 20 20 20 20 20 20 20 20 20 20 20 20 20 20 21 
19 20 20 20 20 20 20 20 20 20 20 20 20 20 20 20 20 20 20 20 20 20 20 20 20 20 20 20 20 20 20 20 20 20 20 20 20 20 20 20 20 20 20 20 20 20 20 20 20 20 20 20 20 20 20 20 20 20 20 21 
19 20 20 20 20 20 20 20 20 20 20 20 20 20 20 20 20 20 20 20 20 20 20 20 20 20 20 20 20 20 20 20 20 20 20 20 20 20 20 20 20 20 20 20 20 20 20 20 20 20 20 20 20 20 20 20 20 20 20 21 
19 20 20 20 20 20 20 20 20 20 20 20 20 20 20 20 20 20 20 20 20 20 20 20 20 20 20 20 20 20 20 20 20 20 20 20 20 20 20 20 20 20 20 20 20 20 20 20 20 20 20 20 20 20 20 20 20 20 20 21 
19 20 20 20 20 20 20 20 20 20 20 20 20 20 20 20 20 20 20 20 20 20 20 20 20 20 20 20 20 20 20 20 20 20 20 20 20 20 20 20 20 20 20 20 20 20 20 20 20 20 20 20 20 20 20 20 20 20 20 21 
19 20 20 20 20 20 20 20 20 20 20 20 20 20 20 20 20 20 20 20 20 20 20 20 20 20 20 20 20 20 20 20 20 20 20 20 20 20 20 20 20 20 20 20 20 20 20 20 20 20 20 20 20 20 20 20 20 20 20 21 
19 20 20 20 20 20 20 20 20 20 20 20 20 20 20 20 20 20 20 20 60 61 61 61 61 61 61 61 61 61 61 61 61 61 61 61 61 61 61 61 61 62 20 20 20 20 20 20 20 20 20 20 20 20 20 20 20 20 20 21 
19 20 20 20 20 20 20 20 20 20 20 20 20 20 20 20 20 20 20 20 63 64 64 64 64 64 64 64 64 64 64 64 64 64 64 64 64 64 64 64 64 65 20 20 20 20 20 20 20 20 20 20 20 20 20 20 20 20 20 21 
19 20 20 20 20 20 20 20 20 20 20 20 20 20 20 20 20 20 20 20 63 64 64 64 64 64 64 64 64 64 64 64 64 64 64 64 64 64 64 64 64 65 20 20 20 20 20 20 20 20 20 20 20 20 20 20 20 20 20 21 
19 20 20 20 20 20 20 20 20 20 20 20 20 20 20 20 20 20 20 20 63 64 64 64 64 64 64 64 64 64 64 64 64 64 64 64 64 64 64 64 64 65 20 20 20 20 20 20 20 20 20 20 20 20 20 20 20 20 20 21 
19 20 20 20 20 20 20 20 20 20 20 20 20 20 20 20 20 20 20 20 63 64 64 64 64 64 64 64 64 64 64 64 64 64 64 64 64 64 64 64 64 65 20 20 20 20 20 20 20 20 20 20 20 20 20 20 20 20 20 21 
19 20 20 20 20 20 20 20 20 20 20 20 20 20 20 20 20 20 20 20 63 64 64 64 64 64 64 64 64 64 64 64 64 64 64 64 64 64 64 64 64 65 20 20 20 20 20 20 20 20 20 20 20 20 20 20 20 20 20 21 
19 20 20 20 20 20 20 20 20 20 20 20 20 20 20 20 20 20 20 20 63 64 64 64 64 64 64 64 64 64 64 64 64 64 64 64 64 64 64 64 64 65 20 20 20 20 20 20 20 20 20 20 20 20 20 20 20 20 20 21 
19 20 20 20 20 20 20 20 20 20 20 20 20 20 20 20 20 20 20 20 63 64 64 64 64 64 64 64 64 64 64 64 64 64 64 64 64 64 64 64 64 65 20 20 20 20 20 20 20 20 20 20 20 20 20 20 20 20 20 21 
19 20 20 20 20 20 20 20 20 20 20 20 20 20 20 20 20 20 20 20 63 64 64 64 64 64 64 64 64 64 64 64 64 64 64 64 64 64 64 64 64 65 20 20 20 20 20 20 20 20 20 20 20 20 20 20 20 20 20 21 
19 20 20 20 20 20 20 20 20 20 20 20 20 20 20 20 20 20 20 20 63 64 64 64 64 64 64 64 64 64 64 64 64 64 64 64 64 64 64 64 64 65 20 20 20 20 20 20 20 20 20 20 20 20 20 20 20 20 20 21 
19 20 20 20 20 20 20 20 20 20 20 20 20 20 20 20 20 20 20 20 63 64 64 64 64 64 64 64 64 64 64 64 64 64 64 64 64 64 64 64 64 65 20 20 20 20 20 20 20 20 20 20 20 20 20 20 20 20 20 21 
19 20 20 20 20 20 20 20 20 20 20 20 20 20 20 20 20 20 20 20 63 64 64 64 64 64 64 64 64 64 64 64 64 64 64 64 64 64 64 64 64 65 20 20 20 20 20 20 20 20 20 20 20 20 20 20 20 20 20 21 
19 20 20 20 20 20 20 20 20 20 20 20 20 20 20 20 20 20 20 20 63 64 64 64 64 64 64 64 64 64 64 64 64 64 64 64 64 64 64 64 64 65 20 20 20 20 20 20 20 20 20 20 20 20 20 20 20 20 20 21 
19 20 20 20 20 20 20 20 20 20 20 20 20 20 20 20 20 20 20 20 63 64 64 64 64 64 64 64 64 64 64 64 64 64 64 64 64 64 64 64 64 65 20 20 20 20 20 20 20 20 20 20 20 20 20 20 20 20 20 21 
19 20 20 20 20 20 20 20 20 20 20 20 20 20 20 20 20 20 20 20 63 64 64 64 64 64 64 64 64 64 64 64 64 64 64 64 64 64 64 64 64 65 20 20 20 20 20 20 20 20 20 20 20 20 20 20 20 20 20 21
19 20 20 20 20 20 20 20 20 20 20 20 20 20 20 20 20 20 20 20 63 64 64 64 64 64 64 64 64 64 64 64 64 64 64 64 64 64 64 64 64 65 20 20 20 20 20 20 20 20 20 20 20 20 20 20 20 20 20 21 
19 20 20 20 20 20 20 20 20 20 20 20 20 20 20 20 20 20 20 20 63 64 64 64 64 64 64 64 64 64 64 64 64 64 64 64 64 64 64 64 64 65 20 20 20 20 20 20 20 20 20 20 20 20 20 20 20 20 20 21 
19 20 20 20 20 20 20 20 20 20 20 20 20 20 20 20 20 20 20 20 63 64 64 64 64 64 64 64 64 64 64 64 64 64 64 64 64 64 64 64 64 65 20 20 20 20 20 20 20 20 20 20 20 20 20 20 20 20 20 21 
19 20 20 20 20 20 20 20 20 20 20 20 20 20 20 20 20 20 20 20 66 67 67 67 67 67 67 67 67 67 67 67 67 67 67 67 67 67 67 67 67 68 20 20 20 20 20 20 20 20 20 20 20 20 20 20 20 20 20 21 
19 20 20 20 20 20 20 20 20 20 20 20 20 20 20 20 20 20 20 20 20 20 20 20 20 20 20 20 20 20 20 20 20 20 20 20 20 20 20 20 20 20 20 20 20 20 20 20 20 20 20 20 20 20 20 20 20 20 20 21 
19 20 20 20 20 20 20 20 20 20 20 20 20 20 20 20 20 20 20 20 20 20 20 20 20 20 20 20 20 20 20 20 20 20 20 20 20 20 20 20 20 20 20 20 20 20 20 20 20 20 20 20 20 20 20 20 20 20 20 21 
19 20 20 20 20 20 20 20 20 20 20 20 20 20 20 20 20 20 20 20 20 20 20 20 20 20 20 20 20 20 20 20 20 20 20 20 20 20 20 20 20 20 20 20 20 20 20 20 20 20 20 20 20 20 20 20 20 20 20 21 
19 20 20 20 20 20 20 20 20 20 20 20 20 20 20 20 20 20 20 20 20 20 20 20 20 20 20 20 20 20 20 20 20 20 20 20 20 20 20 20 20 20 20 20 20 20 20 20 20 20 20 20 20 20 20 20 20 20 20 21 
19 20 20 20 20 20 20 20 20 20 20 20 20 20 20 20 20 20 20 20 20 20 20 20 20 20 20 20 20 20 20 20 20 20 20 20 20 20 20 20 20 20 20 20 20 20 20 20 20 20 20 20 20 20 20 20 20 20 20 21 
19 20 20 20 20 20 20 20 20 20 20 20 20 20 20 20 20 20 20 20 20 20 20 20 20 20 20 20 20 20 20 20 20 20 20 20 20 20 20 20 20 20 20 20 20 20 20 20 20 20 20 20 20 20 20 20 20 20 20 21 
19 20 20 20 20 20 20 20 20 20 20 20 20 20 20 20 20 20 20 20 20 20 20 20 20 20 20 20 20 20 20 20 20 20 20 20 20 20 20 20 20 20 20 20 20 20 20 20 20 20 20 20 20 20 20 20 20 20 20 21 
22 23 23 23 23 23 23 23 23 23 23 23 23 23 23 23 23 23 23 23 23 23 23 23 23 23 23 23 23 23 23 23 23 23 23 23 23 23 23 23 23 23 23 23 23 23 23 23 23 23 23 23 23 23 23 23 23 23 23 24 
