16 17 17 17 17 17 17 17 17 17 17 17 17 17 17 17 17 17 17 17 17 17 17 17 17 17 17 17 17 17 17 17 17 17 17 17 17 17 17 17 17 17 17 17 17 17 17 17 17 17 17 17 17 17 17 17 17 17 17 18 
19 20 20 20 20 20 20 20 20 20 20 20 20 20 20 20 20 20 20 20 20 20 20 20 20 20 20 20 20 20 20 20 20 20 20 20 20 20 20 20 20 20 20 20 20 20 20 20 20 20 20 20 20 20 20 20 20 20 20 21 
19 20 20 20 20 20 20 20 20 20 20 20 20 20 20 20 20 69 70 71 71 71 71 71 71 71 71 71 71 71 71 71 71 71 71 71 71 71 71 71 71 71 71 72 73 20 20 20 20 20 20 20 20 20 20 20 20 20 20 21 
19 20 20 20 20 20 20 20 20 20 20 20 20 20 20 20 20 74 75 75 75 75 75 75 75 75 75 75 75 75 75 75 75 75 75 75 75 75 75 75 75 75 75 75 76 20 20 20 20 20 20 20 20 20 20 20 20 20 20 21
19 20 20 20 20 20 20 20 20 20 20 20 20 20 20 20 20 74 75 75 75 75 75 75 75 75 75 75 75 75 75 75 75 75 75 75 75 75 75 75 75 75 75 75 76 20 20 20 20 20 20 20 20 20 20 20 20 20 20 21
19 20 20 20 20 20 20 20 20 20 20 20 20 20 20 20 20 74 75 75 75 75 75 75 75 75 75 75 75 75 75 75 75 75 75 75 75 75 75 75 75 75 75 75 76 20 20 20 20 20 20 20 20 20 20 20 20 20 20 21 
19 20 20 20 20 20 20 20 20 20 20 20 20 20 20 20 20 77 78 78 78 78 78 78 78 78 78 78 78 78 78 78 78 78 78 78 78 78 78 78 78 78 78 78 79 20 20 20 20 20 20 20 20 20 20 20 20 20 20 21 
19 20 20 20 20 20 20 20 20 20 20 20 20 20 20 20 20 20 20 20 20 20 20 20 20 20 20 20 20 20 20 20 20 20 20 20 20 20 20 20 20 20 20 20 20 20 20 20 20 20 20 20 20 20 20 20 20 20 20 21 
19 20 20 20 20 20 20 20 20 20 20 20 20 20 20 20 20 20 20 20 41 42 43 43 43 43 43 43 43 43 43 43 43 43 43 43 43 43 43 43 44 45 20 20 20 20 20 20 20 20 20 20 20 20 20 20 20 20 20 21 
19 20 20 20 20 20 20 20 20 20 20 20 20 20 20 20 20 20 20 20 46 47 47 47 47 47 47 47 47 47 47 47 47 47 47 47 47 47 47 47 47 48 20 20 20 20 20 20 20 20 20 20 20 20 20 20 20 20 20 21 
19 20 20 20 20 20 20 20 20 20 20 20 20 20 20 20 20 20 20 20 49 50 50 50 50 50 50 50 50 50 50 50 50 50 50 50 50 50 50 50 50 51 20 20 20 20 20 20 20 20 20 20 20 20 20 20 20 20 20 21 
19 20 20 20 20 20 20 20 20 20 20 20 20 20 20 20 20 20 20 20 49 50 50 50 50 50 50 50 50 50 50 50 50 50 50 50 50 50 50 50 50 51 20 20 20 20 20 20 20 20 20 20 20 20 20 20 20 20 20 21 
19 20 20 20 20 20 20 20 20 20 20 20 20 20 20 20 20 20 20 20 49 50 50 50 50 50 50 50 50 50 50 50 50 50 50 50 50 50 50 50 50 51 20 20 20 20 20 20 20 20 20 20 20 20 20 20 20 20 20 21 
19 20 20 20 20 20 20 20 20 20 20 20 20 20 20 20 20 20 20 20 49 50 50 50 50 50 50 50 50 50 50 50 50 50 50 50 50 50 50 50 50 51 20 20 20 20 20 20 20 20 20 20 20 20 20 20 20 20 20 21 
19 20 20 20 20 20 20 20 20 20 20 20 20 20 20 20 20 20 20 20 49 50 50 50 50 50 50 50 50 50 50 50 50 50 50 50 50 50 50 50 50 51 20 20 20 20 20 20 20 20 20 20 20 20 20 20 20 20 20 21 
19 20 20 20 20 20 20 20 20 20 20 20 20 20 20 20 20 20 20 20 49 50 50 50 50 50 50 50 50 50 50 50 50 50 50 50 50 50 50 50 50 51 20 20 20 20 20 20 20 20 20 20 20 20 20 20 20 20 20 21 
19 20 20 20 20 20 20 20 20 20 20 20 20 20 20 20 20 20 20 20 49 50 50 50 50 50 50 50 50 50 50 50 50 50 50 50 50 50 50 50 50 51 20 20 20 20 20 20 20 20 20 20 20 20 20 20 20 20 20 21 
19 20 20 20 20 20 20 20 20 20 20 20 20 20 20 20 20 20 20 20 49 50 50 50 50 50 50 50 50 50 50 50 50 50 50 50 50 50 50 50 50 51 20 20 20 20 20 20 20 20 20 20 20 20 20 20 20 20 20 21 
19 20 20 20 20 20 20 20 20 20 20 20 20 20 20 20 20 20 20 20 49 50 50 50 50 50 50 50 50 50 50 50 50 50 50 50 50 50 50 50 50 51 20 20 20 20 20 20 20 20 20 20 20 20 20 20 20 20 20 21 
19 20 20 20 20 20 20 20 20 20 20 20 20 20 20 20 20 20 20 20 49 50 50 50 50 50 50 50 50 50 50 50 50 50 50 50 50 50 50 50 50 51 20 20 20 20 20 20 20 20 20 20 20 20 20 20 20 20 20 21 
19 20 20 20 20 20 20 20 20 20 20 20 20 20 20 20 20 20 20 20 49 50 50 50 50 50 50 50 50 50 50 50 50 50 50 50 50 50 50 50 50 51 20 20 20 20 20 20 20 20 20 20 20 20 20 20 20 20 20 21 
19 20 20 20 20 20 20 20 20 20 20 20 20 20 20 20 20 20 20 20 49 50 50 50 50 50 50 50 50 50 50 50 50 50 50 50 50 50 50 50 50 51 20 20 20 20 20 20 20 20 20 20 20 20 20 20 20 20 20 21 
19 20 20 20 20 20 20 20 20 20 20 20 20 20 20 20 20 20 20 20 49 50 50 50 50 50 50 50 50 50 50 50 50 50 50 50 50 50 50 50 50 51 20 20 20 20 20 20 20 20 20 20 20 20 20 20 20 20 20 21 
19 20 20 20 20 20 20 20 20 20 20 20 20 20 20 20 20 20 20 20 49 50 50 50 50 50 50 50 50 50 50 50 50 50 50 50 50 50 50 50 50 51 20 20 20 20 20 20 20 20 20 20 20 20 20 20 20 20 20 21 
19 20 20 20 20 20 20 20 20 20 20 20 20 20 20 20 20 20 20 20 52 50 50 50 50 50 50 50 50 50 50 50 50 50 50 50 50 50 50 50 50 54 20 20 20 20 20 20 20 20 20 20 20 20 20 20 20 20 20 21 
19 20 20 20 20 20 20 20 20 20 20 20 20 20 20 20 20 20 20 20 55 56 57 57 57 57 57 57 57 57 57 57 57 57 57 57 57 57 57 57 58 59 20 20 20 20 20 20 20 20 20 20 20 20 20 20 20 20 20 21 
19 20 20 20 20 20 20 20 20 20 20 20 20 20 20 20 20 20 20 20 20 20 20 20 20 20 20 20 20 20 20 20 20 20 20 20 20 20 20 20 20 20 20 20 20 20 20 20 20 20 20 20 20 20 20 20 20 20 20 21 
19 20 20 20 20 20 20 20 20 20 20 20 20 20 20 20 20 20 20 20 20 20 20 20 20 20 20 20 20 20 20 20 20 20 20 20 20 20 20 20 20 20 20 20 20 20 20 20 20 20 20 20 20 20 20 20 20 20 20 21 
19 20 20 20 20 20 20 20 20 20 20 20 20 20 20 20 20 20 20 20 20 20 20 20 20 20 20 20 20 20 20 20 20 20 20 20 20 20 20 20 20 20 20 20 20 20 20 20 20 20 20 20 20 20 20 20 20 20 20 21 
19 20 20 20 20 20 20 20 20 20 20 20 20 20 20 20 20 20 20 20 20 20 20 20 20 20 20 20 20 20 20 20 20 20 20 20 20 20 20 20 20 20 20 20 20 20 20 20 20 20 20 20 20 20 20 20 20 20 20 21 
19 20 20 20 20 20 20 20 20 20 20 20 20 20 20 20 20 20 20 20 20 20 20 20 20 20 20 20 20 20 20 20 20 20 20 20 20 20 20 20 20 20 20 20 20 20 20 20 20 20 20 20 20 20 20 20 20 20 20 21 
19 20 20 20 20 20 20 20 20 20 20 20 20 20 20 20 20 20 20 20 20 20 20 20 20 20 20 20 20 20 20 20 20 20 20 20 20 20 20 20 20 20 20 20 20 20 20 20 20 20 20 20 20 20 20 20 20 20 20 21 
22 23 23 23 23 23 23 23 23 23 23 23 23 23 23 23 23 23 23 23 23 23 23 23 23 23 23 23 23 23 23 23 23 23 23 23 23 23 23 23 23 23 23 23 23 23 23 23 23 23 23 23 23 23 23 23 23 23 23 24 
